{
  "level_001": {
    "number": 1,
    "map": [
      [1,1,1,1,1,1,1,1,1,1,1,1,1,1,1,1],
      [1,1,1,1,1,1,1,1,1,1,1,1,1,1,1,1],
      [1,1,1,1,1,1,1,1,1,1,1,1,1,1,1,1],
      [1,1,1,1,1,1,1,1,1,1,1,1,1,1,1,1],
      [1,1,1,1,1,1,1,1,1,1,1,1,1,1,1,1],
      [1,0,0,0,0,0,0,0,0,0,0,0,0,0,0,1],
      [1,10,0,0,0,0,0,0,0,0,0,0,0,0,100,1],
      [1,1,1,1,1,1,1,1,1,1,1,1,1,1,1,1],
      [1,1,1,1,1,1,1,1,1,1,1,1,1,1,1,1],
      [1,1,1,1,1,1,1,1,1,1,1,1,1,1,1,1],
      [1,1,1,1,1,1,1,1,1,1,1,1,1,1,1,1],
      [1,1,1,1,1,1,1,1,1,1,1,1,1,1,1,1]
    ],
    "buff": {
      "measure": 0.5,
      "x_vel": 5,
      "y_vel": 20,
      "gravity": 3,
      "tall": 25
    }
  },
  "level_002": {
    "number": 2,
    "map": [
     [1,1,1,1,1,1,1,1,1,1,1,1,1,1,1,1],
      [1,1,1,1,1,1,1,1,1,1,1,1,1,1,1,1],
      [1,1,1,1,1,1,1,1,1,1,1,1,1,1,1,1],
      [1,1,1,1,1,1,1,1,1,1,1,1,1,1,1,1],
      [1,1,1,1,1,1,1,1,1,1,1,1,1,1,1,1],
      [1,1,1,1,1,1,1,1,1,1,1,1,1,1,1,1],
      [1,1,1,1,1,0,0,0,0,0,1,1,1,1,1,1],
      [1,10,0,0,0,0,0,0,0,0,0,0,0,0,100,1],
      [1,1,1,1,1,1,1,1,1,1,1,1,1,1,1,1],
      [1,1,1,1,1,1,1,1,1,1,1,1,1,1,1,1],
      [1,1,1,1,1,1,1,1,1,1,1,1,1,1,1,1],
      [1,1,1,1,1,1,1,1,1,1,1,1,1,1,1,1]
    ],
     "buff": {
      "measure": 0.5,
      "x_vel": 5,
      "y_vel": 20,
      "gravity": 3,
       "tall": 25
    }
  },
    "level_003": {
    "number": 3,
    "map": [
      [1,1,1,1,1,1,1,1,1,1,1,1,1,1,1,1],
      [1,1,1,1,1,1,1,1,1,1,1,1,1,1,1,1],
      [1,10,0,0,0,0,0,0,0,0,0,0,0,0,0,1],
      [1,1,1,1,1,1,1,1,1,1,1,1,1,0,0,1],
      [1,1,1,1,1,1,1,1,1,1,1,1,1,0,0,1],
      [1,0,0,0,0,0,0,0,0,0,0,0,0,0,0,1],
      [1,0,0,1,1,1,1,1,1,1,1,1,1,1,1,1],
      [1,0,0,0,0,0,0,0,0,0,0,0,0,0,0,1],
      [1,1,1,1,1,1,1,1,1,1,1,1,1,1,0,1],
      [1,1,1,1,1,1,1,1,1,1,1,1,1,1,0,1],
      [1,100,0,0,0,0,0,0,0,0,0,0,0,0,0,1],
      [1,1,1,1,1,1,1,1,1,1,1,1,1,1,1,1]
    ],
     "buff": {
      "measure": 0.5,
      "x_vel": 5,
      "y_vel": 20,
      "gravity": 3,
       "tall": 25
    }
  },
  "level_004": {
    "number": 4,
    "map": [
      [1,1,1,1,1,1,1,1,1,1,1,1,1,1,1,1],
      [1,1,1,1,1,1,1,1,1,1,1,1,1,1,1,1],
      [1,1,1,1,1,1,1,1,1,1,1,1,1,1,1,1],
      [1,0,0,0,0,0,0,1,1,1,1,1,1,1,1,1],
      [1,0,0,0,0,0,0,0,0,0,0,0,0,0,1,1],
      [1,10,0,0,0,0,0,0,0,0,0,0,0,0,1,1],
      [1,1,1,1,1,1,1,1,1,1,1,1,0,0,1,1],
      [1,1,1,1,1,1,0,0,1,1,1,1,0,0,1,1],
      [1,0,0,0,0,0,0,0,0,0,0,0,0,0,1,1],
      [1,100,1,1,1,1,0,1,1,1,1,1,1,1,1,1],
      [1,1,1,1,1,1,0,1,1,1,1,1,1,1,1,1],
      [1,1,1,1,1,1,0,1,1,1,1,1,1,1,1,1]
    ],
     "buff": {
      "measure": 0.5,
      "x_vel": 5,
      "y_vel": 20,
      "gravity": 3,
       "tall": 25
    }
  },
  "level_005": {
    "number": 5,
    "map": [
      [1,1,1,1,1,1,1,1,1,1,1,1,1,1,1,1],
      [1,1,1,1,1,1,1,1,1,1,1,1,1,1,1,1],
      [1,1,1,1,1,1,1,1,1,1,1,1,1,1,1,1],
      [1,0,0,0,0,0,0,0,0,0,0,0,0,0,0,1],
      [1,0,0,0,0,0,0,0,0,0,0,0,0,0,0,1],
      [1,10,0,0,1,1,1,1,1,1,1,0,0,0,0,1],
      [1,1,1,0,0,0,0,0,0,0,0,0,0,0,100,1],
      [1,1,1,1,1,1,1,1,1,1,1,1,1,1,1,1],
      [1,1,1,1,1,1,1,1,1,1,1,1,1,1,1,1],
      [1,1,1,1,1,1,1,1,1,1,1,1,1,1,1,1],
      [1,1,1,1,1,1,1,1,1,1,1,1,1,1,1,1],
      [1,1,1,1,1,1,1,1,1,1,1,1,1,1,1,1]
    ],
     "buff": {
      "measure": 0.5,
      "x_vel": 5,
      "y_vel": 20,
      "gravity": 3,
       "tall": 25
    }
  }
}
